
        WE ./textures/42.xpm
   EA ./textures/42.xpm


NO ./textures/42.xpm
SO ./textures/42.xpm


F 0,0,0
C 0,0,0

       111111111   111111111111111    
      1000000001  100000000000000011  
     10000000001  1000000111111000001 
    100001100001  1111111     1000001 
   100001 100001              1000001 
  100001  100001              1000001 
 100001   100001           111100001  
100001111110000111    1111100000011   
100000000000000001  1100000000111     
111111111100000111 10000011111        
          100001  1000001             
          100001  1000001             
          100001  1000001       111111
        110000001110000001111111000001
        100000000D000000000000000000W1
        111111111111111111111111111111
