
        WE ./textures/egypt_5.xpm
   EA ./textures/egypt_6.xpm


NO ./textures/egypt_7.xpm
SO ./textures/egypt_2.xpm


F 160,110,15
C 200,165,90

                111111
                111111
             121212121211
         1111000000000001111
       11200000000N00000000111
     11111111D111111111111111111
   1110000000000000000000000000111
  120000000000000000000000000000011
 11000000000000000000000000000000211
1100000000000000000000000000000000011
111111111111111111111111111D111111111
1000000000000000000000000000000000001
1000000000000000000000000000000000001
1100000000000000000000000000000000001
 11000000000000000000000000000000011
  110000000000000000000000000000011
   1100000000000000000000000000011
    11100000000000000000000000111
      1111000000000000000001111
         1111100000000011111
             11111111111