
        100000000000000
       100000000000000
      1110000000000000
     110000000000000000
    1000001111111100000
   10000000000000000000
  100000000000000000000
 1000000000000000000000
 100000000000000000000
100000000000000000000
100000000000000000000
 100000000000000000000
 100000000000000000000
  100000000000000000000
   100000000000000000000
    10000000000000000000
     1000001111111100000
      110000000000000000
        11100000011100000
         1000000000000001

		         ____
    111111111111
  1100000000000011
 110000000000000011
11X00000000000000011
110000000000000000011
110000000000000000011
110000000000000000011
 1000000000000000001
  10000000000000011
   100000000000011
    1000000000011
      100000001

              10000001
            100000000001
         10000000000000001
      1000000000000000000001
    10000000000000000000000001
   1000000000000000000000000001
  100000000000000000000000000001
 10000000000000000000000000000001
 10000000000000000000000000000001
 10000000000000000000000000000001
  100000000000000000000000000001
   1000000000000000000000000001
    10000000000000000000000001
      10000000000000000000001
        10000000000000001
         100000000001
           10000001

             111111111111
         1111$$$$$$$$$$01111
       1110000000000000000001
     111$$$$$$$$$$$$$$$$$$$$$$$1
   111$$$$$$$$$$$$$$$$$$$$$******1
  11$$$$$$$$$$$$$$**""            1
 11$$$$$$$$$$*""                   1
1$$$$$$$*"     ...                 1
1$$$$$*"      z$P**$b               1
1"            "    d$               1
1                J$%.zeL      .e$$$$1
1               4$$$P""    .e$$$$$$$1
 1               "     .e$$$$$$$$$$1
  1               .ze$$$$$$$$$$$$$1
   1    ....ee$$$$$$$$$$$$$$$$$$$1
    111$$$$$$$$$$$$$$$$$$$$$$$$11
      1111$$$$$$$$$$$$$$$$$$111
         11111$$$$$$$$$$1111
             1"******""1        Gilo94'