
        WE ./textures/green.xpm
   EA ./textures/blue.xpm


NO ./textures/red.xpm
SO ./textures/grey.xpm


F 153,204,255
C 128,128,128

111111111111
10000000011
101100000111
1001000000E1
100000000001
111111111111
