
        WE ./textures/green.xpm
   EA ./textures/blue.xpm


NO ./textures/red.xpm
SO ./textures/grey.xpm


F 153,204,255
C 128,128,128

111111211111
10000000011
101200000111
100D00N00001
100000000001
111111211211
