
NO ./textures/grey.xpm
SO ./textures/blue.xpm
WE ./textures/green.xpm
EA ./textures/red.xpm

F 255,215,0
C 139,69,19

     111111111     11111111     1111111111111111111111111111111   111111111111111111111111111111111111111         111               11111111        111111111111111111111      111111111111111111        11111111        1111111111111
   1100000000011   10000001     1000000000000000000000000000001 11000000000000000000000000000000000000001        10001              100000001       100000000000000000000111   1000000000000000001       10000001     1110000000000001
 11000000000000011110000001     1000000000000000000000000000001100000111111000000000000000000000000000001       1000001             1000000001      10000000000000000000000011 10000000000000000001      10000001   110000000000000001
100000001110000000000000001     10000011100000110000000110000000000001     111111110000011000000011000001      100000001            10000000001     100000011110000011111000001110000001110000000001     10000001  1000001111111100001
10000001   1000000111000001     1000001 111111  1000001  1111111000001            111111  1000001  111111     10000000001           100000000001    10000001  1000001    1000001 100001  100000000001    10000001 1000001       111111
1000001     1000001 1000001     1000001         1000001        1000001                    1000001            1000001000001          1000000000001   10000001  1000001     1000001100001  1000000000001   100000011000001              
1000001     1000001 1000001     1000001         1000001         100001111                 1000001           1000001 1000001         10000000100001  10000001  1000001     1000000000001  10000000100001  100000000000001              
1000001     1000001 1000001     1000001         1000001          1100000011111            1000001          1000001   1000001        10000001 100001 10000001  1000001     1000000000001  10000001 100001 100000000000001    1111111111
1000001     1000001 1000001     1000001         1000001            1110000000011          1000001         1000001     1000001       10000001  10000100000001  1000001     1000000000001  10000001  100001000000000000001    1000000001
1000001     1000001 1000001     1000001         1000001               11111100001         1000001        100000111111111000001      10000001   1000000000001  1000001     1000000000001  10000001   10000000000000000001    1111100001
1000001     1000001 1000001     1000001         1000001                    1000001        1000001       10000000000000000000001     10000001    100000000001  1000001     1000001100001  10000001    1000000000011000001        100001
10000001   10000001 10000001   10000001         1000001                    1000001        1000001      1000001111111111111000001    10000001     10000000001  1000001    1000001 100001  10000001     10000000001 1000001       100001
1000000011100000001 1000000011100000001       11000000011      1111111     1000001      11000000011   1000001             1000001   10000001      10000000011110000011111000001110000001110000001      1000000001  1000001111111100001
 11000000000000011   11000000000000011        10000000001      1000000111111000001      10000000001111000001               10000011110000001       100000000000000000000000011 100000000000000001       100000001   110000000000000001
   110000N000011       1100000000011          10000000001      100000000000000011       1000000000000000001                 1000000000000001        100000000000000000000111   100000000000000001        10000001     1110000001110001
     111111111           111111111            11111111111       111111111111111         111111111111111111                   111111111111111         11111111111111111111      111111111111111111         1111111        111111   1111
