             
        WE ./textures/egypt_5.xpm
   EA ./textures/egypt_6.xpm


NO ./textures/egypt_7.xpm
SO ./textures/egypt_2.xpm


F 160,110,15
C 200,165,90
		       1
		     11011
	       110000011
	    111000000000111	 
	  1110000000000000111
    11000000000000000000011
  110000000000000000000000011
1100000000000000000000000000011
1111111111111111111111111111111